#########################################
#                                       S
#                                       #
#                                       #
#                                       #
#                                       #
#                                       #
#                                       #
#                                       #
#                                       #
#                                       #
#                                       #
#                                       #
#                                       #
#                                       #
#                                       #
#                                       #
#                                       #
#                                       #
#                                       #
#                                       #
#                                       #
#                                       #
#                                       #
#                                       #
#                                       #
#                                       #
#                                       #
#                                       #
#                                       #
#                                       #
#                                       #
#                                       #
#                                       #
#                                       #
#                                       #
#                                       #
#                                       #
#                                       #
#                                       F
#########################################